111111111111
100000000001
101001101101
111111001101
100001011111
100100010101
111011010101
100010000001
100010111111
101110000001
100000111111
111111111111